+Dill = Pickle
+Cappello = Alfredo
+Baseball Players = Shit
+Nastro = Blob Fish
+Richards = Mantate
Cont = Cunt
Johnson = Megamind / Long Neck
Morales = Temalle
Mr Fish = Cuddle Fish
Mr Rathbun = Rathbunny / Bruce from nemo
Mr Vanadore = Harry Potter
Mr Walker = Jack Jack
Mr Hipp = John Cena
Mr Murphy = Boss Baby / Lord Farcad / Jack Jack
Mr Liebal = ronnie coleman / buff midget
Pacheco = Pinoceo
Mr Conner = crly fry
Bourdon = Chef Bourdone
Mr Atkins = Junior Commadant / Boy From Toy Story Sid
Mr Judy = Haze Daddy
Mr Henrickson = Woody






Sowards = Kiu with glasses

Baslot = Asian

Croker = Frog







Mutua = Gangster
Davis = Regimental Commander

Goldenstein = ???

Prebor = Hula Girl
Souders = Spider
Timberlake = Brick #Dense (Mentality)
Uraizee = TV static / sick

Baslot = Eye browls

Croker = Rick (& Morty)

Mr Fowler = Jim bro

Dean = Facebook Picture

McCabe = Question Mark

Miss Roper = Candy Cane 

Mr Sullivan = Sid? Sully from Monster Ink

Mr Baker = Smack King / Supreme Commander

Mr Goodwin = Badwin

Mr Hardin = Softin

Mr Yates = Mr Bates (Shoes)

Miss Wrinkler = G3







I think people in those countries aren’t still living under their old oppressors.” (Burgess 63)

Failed revolutions
Getting ride of democracy

